............#....
####....###.#....
####....###.#....
.#.......%..#....
.%..........#....
####....###......
...#..#..........
.#......@%.......
######........###
....###.....#####
....#####........