............#....
####....###.#....
####....###.#....
.#..........#....
............#....
####....###......
...#..#..........
.#......@........
######........###
....###.....#####
....#####........