............#....
####....###.#....
####...%###.#....
.#..........#....
............#....
####....###......
...#..#.........%
.#%.....@%.......
######........###
....###.....#####
....#####.%......